 ..................................................
 .                                                .
 .  #######       #############       #######     .
 .  #.....#       #...........#       #.....#     .
 .  #.<...#       #...........#       #.....#     .
 .  #.....#       #...........#       #.....#     .
 .  ###.###       ######.######       ###.###     .
 .    #.#              #.#              #.#       .
 .    #.#              #.#              #.#       .
 .  ###.###       ######.######       ###.###     .
 .  #.....#       #...........#       #.....#     .
 .  #.....#       #...........#       #.....#     .
 .  #.....#       #...........#       #.....#     .
 .  #######       #############       #######     .
 .                                                .
 ..................................................
